АЭРОПОРТЫ| Аэропорты аЭропорты аэрОпорты аэропОрты. аэропортЫ
БАНТЫ| бАнты. бантЫ
БОРОДУ| бОроду. борОду бородУ
БУХГАЛТЕРОВ| бУхгалтеров бухгАлтеров. бухгалтЕров бухгалтерОв
ВЕРОИСПОВЕДАНИЕ| вЕроисповедание верОисповедание вероИсповедание вероиспОведание вероисповЕдание. вероисповедАние вероисповеданИе вероисповеданиЕ
ВОДОПРОВОД| вОдопровод водОпровод водопрОвод водопровОд.
ГАЗОПРОВОД| гАзопровод газОпровод газопрОвод газопровОд.
ГРАЖДАНСТВО| грАжданство граждАнство. гражданствО
ДЕФИС| дЕфис дефИс.
ДЕШЕВИЗНА| дЕшевизна дешЕвизна дешевИзна. дешевизнА
ДИСПАНСЕР| дИспансер диспАнсер диспансЕр.
ДОГОВОРЁННОСТЬ| дОговорённость догОворённость договОрённость договорЁнность. договорённОсть
ДОКУМЕНТ| дОкумент докУмент докумЕнт.
ДОСУГ| дОсуг досУг.
ЕРЕТИК| Еретик ерЕтик еретИк.
ЖАЛЮЗИ| жАлюзи жалЮзи жалюзИ.
ЗНАЧИМОСТЬ| знАчимость. значИмость значимОсть
ИКСЫ| Иксы. иксЫ
КАТАЛОГ| кАталог катАлог каталОг.
КВАРТАЛ (ВО ВСЕХ ЗНАЧЕНИЯХ)| квАртал квартАл.
КИЛОМЕТР| кИлометр килОметр киломЕтр.
КОНУСОВ| кОнусов. конУсов конусОв
КОРЫСТЬ| кОрысть корЫсть.
КРАНЫ| крАны. кранЫ
КРЕМЕНЬ| крЕмень кремЕнь.
КРЕМНЯ| крЕмня кремнЯ.
ЛЕКТОРОВ| лЕкторов. лектОров лекторОв
ЛОКТЯ| лОктя. локтЯ
ЛЫЖНЯ| лЫжня лыжнЯ.
МЕСТНОСТЕЙ| мЕстностей. местнОстей местностЕй
НАМЕРЕНИЕ| нАмерение намЕрение. намерЕние намеренИе намерениЕ
НАРОСТ| нАрост нарОст.
НЕДРУГ| нЕдруг. недрУг
НЕДУГ| нЕдуг недУг.
НЕКРОЛОГ| нЕкролог некрОлог некролОг.
НЕНАВИСТЬ| нЕнависть. ненАвисть ненавИсть
НЕФТЕПРОВОД| нЕфтепровод нефтЕпровод нефтепрОвод нефтепровОд.
НОВОСТЕЙ| нОвостей новОстей новостЕй.
НОГТЯ| нОгтя. ногтЯ
ОТЗЫВ (О КНИГЕ)| Отзыв. отзЫв
ОТЗЫВ (ПОСЛА ИЗ СТРАНЫ)| Отзыв отзЫв.
ОТРОЧЕСТВО| Отрочество. отрОчество отрочЕство отрочествО
ПАРТЕР| пАртер партЕр.
ПОРТФЕЛЬ| пОртфель портфЕль.
ПОРУЧНИ| пОручни. порУчни поручнИ
ПРИДАНОЕ| прИданое придАное. приданОе приданоЕ
ПРИЗЫВ| прИзыв призЫв.
СВЁКЛА| свЁкла. свёклА
СИРОТЫ| сИроты сирОты. сиротЫ
СОЗЫВ| сОзыв созЫв.
СОСРЕДОТОЧЕНИЕ| сОсредоточение сосрЕдоточение сосредОточение сосредотОчение. сосредоточЕние сосредоточенИе сосредоточениЕ
СРЕДСТВА| срЕдства. средствА
СТАТУЯ| стАтуя. статУя статуЯ
СТОЛЯР| стОляр столЯр.
ТАМОЖНЯ| тАможня тамОжня. таможнЯ
ТОРТЫ| тОрты. тортЫ
ТУФЛЯ| тУфля. туфлЯ
ЦЕМЕНТ| цЕмент цемЕнт.
ЦЕНТНЕР| цЕнтнер. центнЕр
ЦЕПОЧКА| цЕпочка цепОчка. цепочкА
ШАРФЫ| шАрфы. шарфЫ
ШОФЁР| шОфёр шофЁр.
ЭКСПЕРТ| Эксперт экспЕрт.
ВЕРНА| вЕрна вернА.
ЗНАЧИМЫЙ| знАчимый. значИмый значимЫй
КРАСИВЕЕ| крАсивее красИвее. красивЕе красивеЕ
КУХОННЫЙ| кУхонный. кухОнный кухоннЫй
ЛОВКА| лОвка ловкА.
МОЗАИЧНЫЙ| мОзаичный мозАичный мозаИчный. мозаичнЫй
ОПТОВЫЙ| Оптовый оптОвый. оптовЫй
ПРОЗОРЛИВЫЙ| прОзорливый прозОрливый прозорлИвый. прозорливЫй
ПРОЗОРЛИВА| прОзорлива прозОрлива прозорлИва. прозорливА
СЛИВОВЫЙ| слИвовый. сливОвый сливовЫй
БРАЛА| брАла бралА.
БРАЛАСЬ| брАлась бралАсь.
ВЗЯЛА| взЯла взялА.
ВЗЯЛАСЬ| взЯлась взялАсь.
ВЛИЛАСЬ| влИлась влилАсь.
ВОРВАЛАСЬ| вОрвалась ворвАлась ворвалАсь.
ВОСПРИНЯТЬ| вОспринять воспрИнять воспринЯть.
ВОСПРИНЯЛА| вОсприняла воспрИняла воспринЯла воспринялА.
ВОССОЗДАЛА| вОссоздала воссОздала воссоздАла воссоздалА.
ВРУЧИТ| врУчит вручИт.
ГНАЛА| гнАла гналА.
ГНАЛАСЬ| гнАлась гналАсь.
ДОБРАЛА| дОбрала добрАла добралА.
ДОБРАЛАСЬ| дОбралась добрАлась добралАсь.
ДОЖДАЛАСЬ| дОждалась дождАлась дождалАсь.
ДОЗВОНИТСЯ| дОзвонится дозвОнится дозвонИтся. дозвонитсЯ
ДОЗИРОВАТЬ| дОзировать дозИровать. дозирОвать дозировАть
ЖДАЛА| ждАла ждалА.
ЖИЛОСЬ| жИлось жилОсь.
ЗАКУПОРИТЬ| зАкупорить закУпорить. закупОрить закупорИть
ЗАНЯТЬ| зАнять занЯть.
ЗАНЯЛ| зАнял. занЯл
ЗАНЯЛА| зАняла занЯла занялА.
ЗАНЯЛИ| зАняли. занЯли занялИ
ЗАПЕРЛА| зАперла запЕрла заперлА.
ЗАПЛОМБИРОВАТЬ| зАпломбировать заплОмбировать запломбИровать запломбирОвать запломбировАть.
ЗАЩЕМИТ| зАщемит защЕмит защемИт.
ЗВАЛА| звАла звалА.
ЗВОНИТ| звОнит звонИт.
КАШЛЯНУТЬ| кАшлянуть. кашлЯнуть кашлянУть
КЛАЛА| клАла. клалА
КЛЕИТЬ| клЕить. клеИть
КРАЛАСЬ| крАлась. кралАсь
КРОВОТОЧИТЬ| крОвоточить кровОточить кровотОчить кровоточИть.
ЛГАЛА| лгАла лгалА.
ЛИЛА| лИла лилА.
ЛИЛАСЬ| лИлась лилАсь.
НАВРАЛА| нАврала наврАла навралА.
НАДЕЛИТ| нАделит надЕлит наделИт.
НАДОРВАЛАСЬ| нАдорвалась надОрвалась надорвАлась надорвалАсь.
НАЗВАЛАСЬ| нАзвалась назвАлась назвалАсь.
НАКРЕНИТСЯ| нАкренится накрЕнится накренИтся. накренитсЯ
НАЛИЛА| нАлила налИла налилА.
НАРВАЛА| нАрвала нарвАла нарвалА.
НАЧАТЬ| нАчать начАть.
НАЧАЛ| нАчал. начАл
НАЧАЛА| нАчала начАла началА.
НАЧАЛИ| нАчали. начАли началИ
ОБЗВОНИТ| Обзвонит обзвОнит обзвонИт.
ОБЛЕГЧИТЬ| Облегчить облЕгчить облегчИть.
ОБЛЕГЧИТ| Облегчит облЕгчит облегчИт.
ОБЛИЛАСЬ| Облилась облИлась облилАсь.
ОБНЯЛАСЬ| Обнялась обнЯлась обнялАсь.
ОБОГНАЛА| Обогнала обОгнала обогнАла обогналА.
ОБОДРАЛА| Ободрала обОдрала ободрАла ободралА.
ОБОДРИТЬ| Ободрить обОдрить ободрИть.
ОБОДРИТ| Ободрит обОдрит ободрИт.
ОБОДРИТЬ| Ободрить обОдрить ободрИть.
ОБОДРИТ| Ободрит обОдрит ободрИт.
ОБОСТРИТЬ| Обострить обОстрить обострИть.
ОДОЛЖИТЬ| Одолжить одОлжить одолжИть.
ОДОЛЖИТ| Одолжит одОлжит одолжИт.
ОЗЛОБИТЬ| Озлобить озлОбить. озлобИть
ОКЛЕИТЬ| Оклеить оклЕить. оклеИть
ОКРУЖИТ| Окружит окрУжит окружИт.
ОПОШЛИТЬ| Опошлить опОшлить. опошлИть
ОСВЕДОМИТЬСЯ| Осведомиться освЕдомиться. осведОмиться осведомИться осведомитьсЯ
ОСВЕДОМИТСЯ| Осведомится освЕдомится. осведОмится осведомИтся осведомитсЯ
ОТБЫЛА| Отбыла отбЫла отбылА.
ОТДАЛА| Отдала отдАла отдалА.
ОТКУПОРИТЬ| Откупорить откУпорить. откупОрить откупорИть
ОТОЗВАЛА| Отозвала отОзвала отозвАла отозвалА.
ОТОЗВАЛАСЬ| Отозвалась отОзвалась отозвАлась отозвалАсь.
ПЕРЕЗВОНИТ| пЕрезвонит перЕзвонит перезвОнит перезвонИт.
ПЕРЕЛИЛА| пЕрелила перЕлила перелИла перелилА.
ПЛОДОНОСИТЬ| плОдоносить плодОносить плодонОсить плодоносИть.
ПЛОМБИРОВАТЬ| плОмбировать пломбИровать пломбирОвать пломбировАть.
ПОВТОРИТ| пОвторит повтОрит повторИт.
ПОЗВАЛА| пОзвала позвАла позвалА.
ПОЗВОНИТ| пОзвонит позвОнит позвонИт.
ПОЛИЛА| пОлила полИла полилА.
ПОЛОЖИТЬ| пОложить полОжить положИть.
ПОЛОЖИЛ| пОложил полОжил положИл.
ПОНЯТЬ| пОнять понЯть.
ПОНЯЛА| пОняла понЯла понялА.
ПОСЛАЛА| пОслала послАла. послалА
ПРИБЫТЬ| прИбыть прибЫть.
ПРИБЫЛ| прИбыл. прибЫл
ПРИБЫЛА| прИбыла прибЫла прибылА.
ПРИБЫЛИ| прИбыли. прибЫли прибылИ
ПРИНЯТЬ| прИнять принЯть.
ПРИНЯЛ| прИнял. принЯл
ПРИНЯЛА| прИняла принЯла принялА.
ПРИНЯЛИ| прИняли. принЯли принялИ
РВАЛА| рвАла рвалА.
СВЕРЛИТ| свЕрлит сверлИт.
СНЯЛА| снЯла снялА.
СОВРАЛА| сОврала соврАла совралА.
СОЗДАЛА| сОздала создАла создалА.
СОРВАЛА| сОрвала сорвАла сорвалА.
СОРИТ| сОрит сорИт.
УБРАЛА| Убрала убрАла убралА.
УГЛУБИТЬ| Углубить углУбить углубИть.
УКРЕПИТ| Укрепит укрЕпит укрепИт.
ЧЕРПАТЬ| чЕрпать. черпАть
ЩЕМИТ| щЕмит щемИт.
ЩЁЛКАТЬ| щЁлкать. щёлкАть
ДОВЕЗЁННЫЙ| дОвезённый довЕзённый довезЁнный. довезённЫй
ЗАГНУТЫЙ| зАгнутый. загнУтый загнутЫй
ЗАНЯТЫЙ| зАнятый. занЯтый занятЫй
ЗАНЯТА| зАнята занЯта занятА.
ЗАПЕРТЫЙ| зАпертый. запЕртый запертЫй
ЗАСЕЛЁННЫЙ| зАселённый засЕлённый заселЁнный. заселённЫй
ЗАСЕЛЕНА| зАселена засЕлена заселЕна заселенА.
КОРМЯЩИЙ| кОрмящий кормЯщий. кормящИй
КРОВОТОЧАЩИЙ| крОвоточащий кровОточащий кровотОчащий кровоточАщий. кровоточащИй
НАЖИВШИЙ| нАживший нажИвший. нажившИй
НАЛИВШИЙ| нАливший налИвший. налившИй
НАНЯВШИЙСЯ| нАнявшийся нанЯвшийся. нанявшИйся нанявшийсЯ
НАЧАВШИЙ| нАчавший начАвший. начавшИй
НАЧАТЫЙ| нАчатый. начАтый начатЫй
НИЗВЕДЁННЫЙ| нИзведённый низвЕдённый низведЁнный. низведённЫй
ОБЛЕГЧЁННЫЙ| Облегчённый облЕгчённый облегчЁнный. облегчённЫй
ОБОДРЁННЫЙ| Ободрённый обОдрённый ободрЁнный. ободрённЫй
ОБОСТРЁННЫЙ| Обострённый обОстрённый обострЁнный. обострённЫй
ОТКЛЮЧЁННЫЙ| Отключённый отклЮчённый отключЁнный. отключённЫй
ПОВТОРЁННЫЙ| пОвторённый повтОрённый повторЁнный. повторённЫй
ПОДЕЛЁННЫЙ| пОделённый подЕлённый поделЁнный. поделённЫй
ПОНЯВШИЙ| пОнявший понЯвший. понявшИй
ПРИНЯТЫЙ| прИнятый. принЯтый принятЫй
ПРИНЯТА| прИнята принЯта принятА.
ПРИРУЧЁННЫЙ| прИручённый прирУчённый приручЁнный. приручённЫй
ПРОЖИВШИЙ| прОживший прожИвший. прожившИй
СНЯТА| снЯта снятА.
СНЯТЫЙ| снЯтый. снятЫй
СОГНУТЫЙ| сОгнутый. согнУтый согнутЫй
УГЛУБЛЁННЫЙ| Углублённый углУблённый углублЁнный. углублённЫй
ЗАКУПОРИВ| зАкупорив закУпорив. закупОрив закупорИв
НАЧАВ| нАчав начАв.
НАЧАВШИСЬ| нАчавшись начАвшись. начавшИсь
ОТДАВ| Отдав отдАв.
ПОДНЯВ| пОдняв поднЯв.
ПОНЯВ| пОняв понЯв.
ПРИБЫВ| прИбыв прибЫв.
СОЗДАВ| сОздав создАв.
ВОВРЕМЯ| вОвремя. воврЕмя вовремЯ
ДОВЕРХУ| дОверху. довЕрху доверхУ
ДОНЕЛЬЗЯ| дОнельзя донЕльзя. донельзЯ
ДОНИЗУ| дОнизу. донИзу донизУ
ДОСУХА| дОсуха. досУха досухА
ЗАСВЕТЛО| зАсветло. засвЕтло засветлО
ЗАТЕМНО| зАтемно. затЕмно затемнО
КРАСИВЕЕ| крАсивее красИвее. красивЕе красивеЕ
КРАСИВО| крАсиво красИво. красивО
НАДОЛГО| нАдолго надОлго. надолгО
НЕНАДОЛГО| нЕнадолго ненАдолго ненадОлго. ненадолгО
ЦЫГАН| цЫган цыгАн.
ПОЧЕСТЕЙ| пОчестей. почЕстей почестЕй
СВЕКЛА| свЁкла. свеклА
ПОНЯВ| пОняв понЯв.